111111
1C01P1
100101
110101
1E0001
111111