111111
1CC1P1
1CC101
111101
1ECCC1
111111