11111111111111111
1CM01E10001000011
1000101010100M001
10001000100000001
11101111111110001
10000000000010001
1000000100C000001
10P00000001000001
10111000001000M01
100C100C001000001
11110000001000001
11111111111111111
