11111100000001
1CC1P100000001
1CC0C100000001
1CCCC100000001
1ECCC100000001
11111100000001