111111
1P0001
1EC001
1C0001
111111