1111111111111111
1P100000100C0001
1E00000010000001
1000000010010001
1001110000010001
100000000001C001
1000000011100001
100C00000C000001
1111111111111111