11111111111111111
1C001E10001000011
10001010101000001
10001000100000001
11101111111110001
10000000000010001
1000000000C000001
10P0000C001000001
10111000C01000001
100C100C001000001
11110000001000001
11111111111111111